1111111111111
10E0000000001
1000P00000001
1000000C00001
1111111111111