111111111111111111111111111
100000000000000000000000001
100000000000000011111111101
10000000000000C001000000001
1000000000000000100E0000001
1000000000000000100C0010001
100111100010000000000000001
100000111111111111111111111
1001111C00CCCCCCCCCCCCC0001
1000111111001111110000C0001
100000000000111111001P00001
111111111111111111111111111