111111111111111111111
100000000000000000001
100000000010000000001
100000000010000000001
1000000000100E0000001
1000000000100C0010001
100111100010000000001
100000111111111111111
100111100000000000001
100011111100000000001
10000000000000P000001
111111111111111111111