111111111111111111111111111
100000000000000000000000001
100000000000000011111111101
100000E0000000C001000000001
1000000000000000000E0000001
100000000P000000000C0010001
100111100010000000000000001
100000111111111111000111111
10011110000E000000000000001
1000111111001111110000C0001
100000000000111111P0100E001
111111111111111111111111111