111111111111111111111111111
100000H000H00H0000000000001
100000111111100111111111101
100000100000001001000000001
100000100000000000E001000V1
100000100000000H00C00101001
1V0111100000100000H000C0001
1010001111111111110V0111111
10011110000E000000001000001
1000111111001111110000C0001
100000H00000111111P0100EP01
111111111111111111111111111