111111111111111111111111111
100000H00000000000000000001
100000111111100111111111101
100000100E00001001000000001
100000100000H0000000E1000V1
100000100000000000C00101001
1V0111100000100000H000C0001
1010001111111111110V0111111
1001111000E0000000001000001
1000111111001111110000C0001
100000H00000111111P0100EP01
111111111111111111111111111