1111111111111111
1000000000000001
10P0000V00C00E01
1000000000000001
1111111111111111