1111111111111111
1000000000000001
10P0000000C00G01
1000000000000001
1111111111111111