111111111111111111111
1P000000000000000001
10000000000CCCCC00001
100E00000000000000001
111111111111111111111