1111111111111111
1000000000000001
10P0000000C00001
1000000000000001
1111111111111111